ZONA I
../data/megaman_iceman_level.png
../data/parallax-1-800x200.png
../data/parallax-2-800x120.png
7 5
30 8
13 00 00 00 00 00 00 00 00 00 00 00 00 00 00 00 00 00 00 00 00 00 00 21 14 00 00 02 02 09
13 00 00 00 00 00 00 00 00 00 00 01 02 28 02 00 00 00 00 00 00 00 00 00 00 00 00 00 00 13
13 00 00 00 00 00 00 00 00 00 00 00 00 35 00 00 00 00 00 00 00 00 00 01 28 00 28 02 28 21
19 00 00 00 00 00 00 00 00 00 00 00 00 35 00 00 02 28 00 09 05 08 00 00 35 00 35 00 35 00
17 00 15 08 25 09 15 15 08 25 15 25 09 05 08 25 25 35 25 21 14 32 25 25 05 25 25 25 35 25
13 12 14 32 25 21 12 14 32 25 14 25 25 25 25 25 25 35 25 25 25 25 25 25 25 25 25 25 35 25
13 25 25 25 25 25 25 25 25 25 25 25 25 25 25 25 25 35 25 25 25 25 25 25 25 25 25 25 35 25
11 16 16 16 16 16 16 16 16 16 16 16 16 16 16 16 16 16 16 16 16 16 16 16 16 16 16 16 16 16

01 01 01 01 00 00 00 00 00 00 00 60 62 00 61 00 00 00 00 00 00 00 00 00 01 00 00 01 01 01
01 00 99 00 00 00 00 00 00 00 00 01 01 01 01 00 00 00 00 00 00 00 00 00 61 00 00 00 60 11
01 00 00 00 00 00 00 00 00 00 00 00 00 01 00 00 61 60 00 00 60 00 00 01 01 00 01 01 01 01
01 00 00 20 00 00 60 00 61 00 00 00 00 01 00 00 01 01 00 01 01 01 00 00 01 00 01 00 01 01
01 00 01 01 00 01 01 01 01 00 01 00 01 01 01 00 00 01 00 01 01 01 00 00 01 00 00 00 01 01
01 01 01 01 00 01 01 01 01 00 00 00 00 00 00 00 00 01 00 00 00 00 00 00 00 00 00 00 01 01
01 00 00 62 00 10 00 03 00 61 03 00 62 00 61 60 03 01 00 60 00 03 00 62 00 61 00 00 01 01
01 01 01 01 01 01 01 01 01 01 01 01 01 01 01 01 01 01 01 01 01 01 01 01 01 01 01 01 01 01

00 00 00 00 00 00 00 00 00 00 00 00 00 00 00 00 00 00 00 00 00 00 00 00 00 00 00 00 00 00
00 00 00 00 00 00 00 00 00 00 00 00 00 00 00 04 00 00 00 00 00 00 00 00 00 00 00 00 00 27
00 00 00 00 00 00 00 00 00 00 00 00 00 00 00 00 00 00 00 24 00 00 00 00 00 00 00 00 34 00
00 00 00 30 00 00 00 00 00 00 00 00 00 00 00 00 00 00 00 00 00 00 00 00 00 00 00 00 00 00
00 00 00 00 00 00 00 00 00 00 00 00 00 00 00 00 00 00 00 00 00 00 00 00 00 00 00 00 00 00
00 34 00 00 00 00 00 00 00 00 00 00 00 26 00 00 00 00 00 00 00 00 00 00 00 00 00 00 00 00
00 00 00 00 00 27 00 00 00 00 06 00 25 25 25 00 06 24 00 00 00 06 00 00 00 00 00 00 24 00
00 00 00 00 34 00 00 00 00 00 00 00 00 00 00 00 00 00 00 00 00 00 00 00 00 00 00 00 00 00

10 ../data/level2.lev
11 ../data/level4.lev