../data/megaman_iceman_level.png
7 5
30 8
13 00 00 00 00 00 00 00 00 00 00 00 00 00 00 00 00 00 00 00 00 00 00 21 14 00 00 02 02 09
13 00 00 00 00 00 00 00 00 00 00 01 02 28 02 00 00 00 00 00 00 00 00 00 00 00 00 00 00 13
13 00 00 00 00 00 00 00 00 00 00 00 00 35 00 00 00 00 00 00 00 00 00 01 28 00 28 02 28 21
19 00 00 00 00 00 00 00 00 00 00 00 00 35 00 00 02 28 00 09 05 08 00 00 35 00 35 00 35 00
17 05 15 08 00 09 15 15 08 00 00 00 09 05 08 00 00 35 00 21 14 32 00 00 05 00 00 00 35 00
13 12 14 32 25 21 12 14 32 00 00 00 00 00 00 00 00 35 00 00 00 00 00 00 00 00 00 00 35 00
13 25 25 25 25 25 25 25 25 00 00 00 00 00 00 00 06 35 00 00 00 06 00 00 00 00 00 00 35 00
11 16 16 16 16 16 16 16 16 16 16 16 16 16 16 16 16 16 16 16 16 16 16 16 16 16 16 16 16 16

01 01 01 01 00 00 00 00 00 00 00 00 00 00 00 00 00 00 00 00 00 00 00 00 01 00 00 01 01 01
01 00 00 00 00 00 00 00 00 00 00 01 01 01 01 00 00 00 00 00 00 00 00 00 00 00 00 00 00 01
01 00 00 00 00 00 00 00 00 00 00 00 00 01 00 00 00 00 00 00 00 00 00 01 01 00 01 01 01 01
01 00 00 00 00 00 00 00 00 00 00 00 00 01 00 00 01 01 00 01 01 01 00 00 01 00 01 00 01 01
01 01 01 01 00 01 01 01 01 00 00 00 01 01 01 00 00 01 00 01 01 01 00 00 01 00 00 00 01 01
01 01 01 01 00 01 01 01 01 00 00 00 00 00 00 00 00 01 00 00 00 00 00 00 00 00 00 00 01 01
01 00 00 00 00 00 00 00 00 00 00 00 00 00 00 00 01 01 00 00 00 01 00 00 00 00 00 00 01 01
01 01 01 01 01 01 01 01 01 01 01 01 01 01 01 01 01 01 01 01 01 01 01 01 01 01 01 01 01 01

00 00 00 00 00 00 00 00 00 00 00 00 00 00 00 00 00 00 00 00 00 00 00 00 00 00 00 00 00 00
00 00 00 00 00 00 00 00 00 00 00 00 00 00 00 04 00 00 00 00 00 00 00 00 00 00 00 00 00 27
00 00 00 00 00 00 00 00 00 00 00 00 00 00 00 00 00 00 00 00 00 00 00 00 00 00 00 00 00 00
00 00 00 00 00 00 00 00 00 00 00 00 00 00 00 00 00 00 00 00 00 00 00 00 00 00 00 00 00 00
00 00 00 00 00 00 00 00 00 00 00 00 00 00 00 00 00 00 00 00 00 00 00 00 00 00 00 00 00 00
00 00 00 00 00 00 00 00 00 00 00 00 00 26 00 00 00 00 00 00 00 00 00 00 00 00 00 00 00 00
00 00 00 00 00 00 00 00 00 00 00 00 00 00 00 00 00 24 00 00 00 00 00 00 00 00 00 00 24 00
00 00 00 00 00 00 00 00 00 00 00 00 00 00 00 00 00 00 00 00 00 00 00 00 00 00 00 00 00 00