../data/megaman_iceman_level.png
5 3
30 8

-1 -1 -1 -1 -1 -1 -1 -1 -1 -1  -1 -1 -1 -1 -1 -1 -1 -1 -1 -1 -1 -1 -1 -1 -1 -1 -1 -1 -1 -1 
-1 -1 -1 -1 -1 11 12 -1 -1 -1  -1 -1 -1 -1 -1 11 12 -1 -1 -1 -1 -1 -1 -1 -1 11 12 -1 -1 -1 
 2  0 -1 -1 -1 10 -1 -1 -1 -1  -1  0 -1 -1 -1 10 -1 -1 -1 -1 -1 -1 -1 -1 -1 10 -1 -1 -1  0 
 9 -1 -1 -1 -1  0 -1 -1 -1  0  -1 -1 -1 -1 -1  0 -1 -1 -1  0 -1 -1 -1 -1 -1  0 -1 -1 -1  1 
 9 -1 -1  6 -1  1 -1 -1  0  1   2 -1 -1  6 -1  1 -1 -1  0  1  2 -1 -1  6 -1  1 -1 -1  0  1 
 8  5  5  7  0  1  0  0  1  1   8  5  5  7  0  1  0  0  1  1  8 -1  5  7  0  1  0 -1  1  1 
 1  1  1  1  1  1  1  1  1  1   1  1  1  1  1  1  1  1 -1 -1 -1 -1  1 -1 -1 -1 -1 -1  1  1 
 1  1  1  1  1  1  1  1  1  1   1  1  1  1  1  1  1  1  1  1  1  1  1  1  1  1  1  1  1  1 


0 0 0 0 0 0 0 0 0 0 0 0 0 0 0 0 0 0 0 0 0 0 0 0 0 0 0 0 0 0
0 0 0 0 0 0 0 0 0 0 0 0 0 0 0 0 0 0 0 0 0 0 0 0 0 0 0 0 0 0
1 1 0 0 0 0 0 0 0 0 0 1 0 0 0 0 0 0 0 0 0 1 0 0 0 0 0 0 0 1 
1 0 0 0 0 1 0 0 0 1 0 0 0 0 0 1 0 0 0 1 0 0 0 0 0 1 0 0 0 1 
1 0 0 1 0 1 0 0 1 1 1 0 0 1 0 1 0 0 1 1 1 0 0 1 0 1 0 0 1 1 
1 1 1 1 1 1 1 1 1 1 1 1 1 1 1 1 1 1 1 1 1 0 1 1 1 1 1 0 1 1
1 1 1 1 1 1 1 1 1 1 1 1 1 1 1 1 1 1 0 0 0 0 1 0 0 0 0 0 1 1
1 1 1 1 1 1 1 1 1 1 1 1 1 1 1 1 1 1 1 1 1 1 1 1 1 1 1 1 1 1
